fish --> fish
chamois --> chamois
sheep --> sheep
reindeer --> reindeer
smallpox --> smallpox
bison --> bison
beef --> beefs
brother --> brothers
child --> children
octopus --> octopuses
soliloquy --> soliloquies
blouse --> blouses
louse --> lice
mouse --> mice
foot --> feet
vertebra --> vertebrae
codex --> codices
archipelago --> archipelagos
fiasco --> fiascos
fishwife --> fishwives
weetabix --> weetabixes
thermos --> thermoses
wolf --> wolves
dress --> dresses
church --> churches
gas --> gases
mantis --> mantises
fez --> fezes
army --> armies
harpy --> harpies
dog --> dogs
